NO ./images/goat_32.xpm
SO ./images/egypt.xpm
WE ./images/tnt.xpm
EA ./images/peng.xpm
F 204,102,0

C 102,0,204
1111111111111111111111111111111111111
1000000000000000000000000000000001111
1000011000000001111100000000000001111
1000011000000000000000000000000001111
10000000000000100000000000000000001111
100000001111111110000000000N0000011
10000000111111111000000100000000011
10000000000000000000000000000000011
10011100000000000000000000000100011
1001110000000000100000000000010001
10000000000000000100000000000000011
10000000000000000000000000000000011
10011100000000000000000000000100011
1001110000000000000000000000010001
10000000000000000000000000000000011
10000000000000000000000000000000011
111111111111111111111111111111111111111
 
1111111111111111
111111111111
111111111111111111111111

